###################################
#.................................#
#......*..........................#
#.................................#
#.........................*.......#
#...............*.................#
#.................................#
#.......*....................*....#
#.................................#
#.................................#
#.................................#
#.................................#
#.................................#
#.................................#
#.................................#
###################################