##############################
#.....*................*.....#
#...............*............#
#......*................*....#
#.............##.............#
#....*....##########.........#
#........................*...#
#.......*......*.............#
#............................#
#............................#
#............................#
##############################

