####################################
#########...................########
########.....................#######
#######......#####.............#####
######...**......................###
#####...............****..........##
####.........#########.............#
###................................#
##...****.....****......****.......#
#..................................#
##..........................########
######.............................#
################...................#
#..................................#
#..................................#
#..................................#
#..................................#
####################################
